{
  "$": "s",
  "@": "a",
  "!": "i",
  "|": "l",
  "+": "t",
  "€": "e",
  "£": "l",
  "¥": "y",
  "¢": "c",
  "§": "s",
  "0": "o",
  "1": "l",
  "2": "z",
  "3": "e",
  "4": "a",
  "5": "s",
  "6": "g",
  "7": "t",
  "8": "b",
  "9": "g",
  "Α": "a",
  "α": "a",
  "А": "a",
  "а": "a",
  "Β": "b",
  "β": "b",
  "В": "b",
  "в": "b",
  "Ь": "b",
  "ь": "b",
  "Ϲ": "c",
  "ϲ": "c",
  "С": "c",
  "с": "c",
  "ԁ": "d",
  "Ε": "e",
  "ε": "e",
  "ϵ": "e",
  "Е": "e",
  "е": "e",
  "Ё": "e",
  "ё": "e",
  "Є": "e",
  "є": "e",
  "Η": "h",
  "Н": "h",
  "н": "h",
  "Һ": "h",
  "һ": "h",
  "Ι": "i",
  "ι": "i",
  "І": "i",
  "і": "i",
  "Ї": "i",
  "ї": "i",
  "Ӏ": "i",
  "Ј": "j",
  "ј": "j",
  "Κ": "k",
  "κ": "k",
  "К": "k",
  "к": "k",
  "ӏ": "l",
  "Μ": "m",
  "М": "m",
  "м": "m",
  "Ν": "n",
  "Π": "n",
  "П": "n",
  "п": "n",
  "Ο": "o",
  "ο": "o",
  "О": "o",
  "о": "o",
  "Θ": "o",
  "θ": "o",
  "Ө": "o",
  "ө": "o",
  "Ρ": "p",
  "ρ": "p",
  "Р": "p",
  "р": "p",
  "Ѕ": "s",
  "ѕ": "s",
  "Τ": "t",
  "τ": "t",
  "Т": "t",
  "т": "t",
  "Υ": "y",
  "υ": "u",
  "У": "y",
  "у": "y",
  "Ү": "y",
  "ү": "y",
  "ν": "v",
  "ѵ": "v",
  "Χ": "x",
  "χ": "x",
  "Х": "x",
  "х": "x",
  "Ζ": "z",
  "ζ": "z",
  "З": "z",
  "з": "z"
}